2 13 31
###############################
#p     s* *  1 *   *  * * *   #
# # # #*# # #*#*# # # #*#*#*# #
#  x*     b**  *      *   * * #
# # # # # #*# # #*#*# # # # #*#
#f         x **  *  *         #
# # # # # # # # # #*# #*# # # #
#*  *      *  *      *        #
# # # # #*# # # #*#*# # # # # #
# # # # #*# # # #*#*# # # # # #
# # # # #*# # # #*#*# # # # # #
#      ###    ####            #
###############################


