1 13 31
###############################
#     1            b          #
#           1    1     1      #
#   1    sbbf                 #
#  s              px      bsf #
#      1                   1  #
#            1  sbbf          #
#  1    1     1      1        #
#       1                  1  #
#    f        fbsb      1     #
#       1        1     1      #
#       1                 1   #
###############################